"wave","la","old.la","novo_entries","def_exit","net","cum_homes","rate","lpa"
"0","Adur","45UB",19,0,19,19,NA,"adur"
"0","Allerdale","16UB",43,0,43,43,NA,"allerdale"
"1","Allerdale","16UB",2,2,0,43,4.65,"allerdale"
"2","Allerdale","16UB",2,2,0,43,4.65,"allerdale"
"3","Allerdale","16UB",2,0,2,45,4.65,"allerdale"
"0","Amber Valley","17UB",38,0,38,38,NA,"amber valley"
"1","Amber Valley","17UB",4,1,3,41,10.53,"amber valley"
"3","Amber Valley","17UB",1,2,-1,40,2.44,"amber valley"
"0","Arun","45UC",91,0,91,91,NA,"arun"
"1","Arun","45UC",9,1,8,99,9.89,"arun"
"3","Arun","45UC",1,4,-3,96,1.01,"arun"
"0","Ashfield","37UB",40,0,40,40,NA,"ashfield"
"1","Ashfield","37UB",12,1,11,51,30,"ashfield"
"2","Ashfield","37UB",1,4,-3,48,1.96,"ashfield"
"3","Ashfield","37UB",3,3,0,48,6.25,"ashfield"
"0","Ashford","29UB",38,0,38,38,NA,"ashford"
"1","Ashford","29UB",6,2,4,42,15.79,"ashford"
"2","Ashford","29UB",1,1,0,42,2.38,"ashford"
"0","Aylesbury Vale","11UB",40,0,40,40,NA,"aylesbury vale"
"1","Aylesbury Vale","11UB",14,3,11,51,35,"aylesbury vale"
"2","Aylesbury Vale","11UB",2,2,0,51,3.92,"aylesbury vale"
"3","Aylesbury Vale","11UB",1,3,-2,49,1.96,"aylesbury vale"
"0","Babergh","42UB",24,0,24,24,NA,"babergh"
"1","Babergh","42UB",6,0,6,30,25,"babergh"
"2","Babergh","42UB",1,2,-1,29,3.33,"babergh"
"0","Barking and Dagenham","00AB",20,0,20,20,NA,"barking and dagenham"
"1","Barking and Dagenham","00AB",8,6,2,22,40,"barking and dagenham"
"2","Barking and Dagenham","00AB",2,2,0,22,9.09,"barking and dagenham"
"3","Barking and Dagenham","00AB",1,1,0,22,4.55,"barking and dagenham"
"0","Barnet","00AC",106,0,106,106,NA,"barnet"
"1","Barnet","00AC",6,12,-6,100,5.66,"barnet"
"2","Barnet","00AC",1,5,-4,96,1,"barnet"
"3","Barnet","00AC",1,12,-11,85,1.04,"barnet"
"0","Barnsley","00CC",57,0,57,57,NA,"barnsley"
"1","Barnsley","00CC",13,5,8,65,22.81,"barnsley"
"2","Barnsley","00CC",3,1,2,67,4.62,"barnsley"
"0","Barrow-in-Furness","16UC",14,0,14,14,NA,"barrow-in-furness"
"1","Barrow-in-Furness","16UC",1,2,-1,13,7.14,"barrow-in-furness"
"0","Basildon","22UB",36,0,36,36,NA,"basildon"
"1","Basildon","22UB",5,1,4,40,13.89,"basildon"
"3","Basildon","22UB",1,2,-1,39,2.5,"basildon"
"0","Basingstoke and Deane","24UB",39,0,39,39,NA,"basingstoke and deane"
"1","Basingstoke and Deane","24UB",6,2,4,43,15.38,"basingstoke and deane"
"2","Basingstoke and Deane","24UB",1,3,-2,41,2.33,"basingstoke and deane"
"3","Basingstoke and Deane","24UB",2,2,0,41,4.88,"basingstoke and deane"
"0","Bassetlaw","37UC",32,0,32,32,NA,"bassetlaw"
"1","Bassetlaw","37UC",9,1,8,40,28.12,"bassetlaw"
"2","Bassetlaw","37UC",1,1,0,40,2.5,"bassetlaw"
"3","Bassetlaw","37UC",1,1,0,40,2.5,"bassetlaw"
"0","Bath and North East Somerset UA","00HA",55,0,55,55,NA,"bath and north east somerset "
"1","Bath and North East Somerset UA","00HA",9,3,6,61,16.36,"bath and north east somerset "
"0","Bedford UA","00KB",60,0,60,60,NA,"bedford "
"1","Bedford UA","00KB",12,6,6,66,20,"bedford "
"2","Bedford UA","00KB",2,2,0,66,3.03,"bedford "
"3","Bedford UA","00KB",1,2,-1,65,1.52,"bedford "
"0","Bexley","00AD",32,0,32,32,NA,"bexley"
"1","Bexley","00AD",4,2,2,34,12.5,"bexley"
"2","Bexley","00AD",2,1,1,35,5.88,"bexley"
"3","Bexley","00AD",2,2,0,35,5.71,"bexley"
"0","Birmingham","00CN",273,0,273,273,NA,"birmingham"
"1","Birmingham","00CN",52,20,32,305,19.05,"birmingham"
"2","Birmingham","00CN",12,27,-15,290,3.93,"birmingham"
"3","Birmingham","00CN",15,17,-2,288,5.17,"birmingham"
"0","Blaby","31UB",23,0,23,23,NA,"blaby"
"1","Blaby","31UB",2,3,-1,22,8.7,"blaby"
"2","Blaby","31UB",1,0,1,23,4.55,"blaby"
"0","Blackburn with Darwen UA","00EX",35,0,35,35,NA,"blackburn with darwen "
"1","Blackburn with Darwen UA","00EX",2,2,0,35,5.71,"blackburn with darwen "
"2","Blackburn with Darwen UA","00EX",1,3,-2,33,2.86,"blackburn with darwen "
"3","Blackburn with Darwen UA","00EX",2,4,-2,31,6.06,"blackburn with darwen "
"0","Blackpool UA","00EY",76,0,76,76,NA,"blackpool "
"1","Blackpool UA","00EY",7,5,2,78,9.21,"blackpool "
"2","Blackpool UA","00EY",1,6,-5,73,1.28,"blackpool "
"0","Bolsover","17UC",23,0,23,23,NA,"bolsover"
"1","Bolsover","17UC",5,0,5,28,21.74,"bolsover"
"0","Bolton","00BL",38,0,38,38,NA,"bolton"
"1","Bolton","00BL",9,0,9,47,23.68,"bolton"
"3","Bolton","00BL",4,2,2,49,8.51,"bolton"
"0","Boston","32UB",17,0,17,17,NA,"boston"
"1","Boston","32UB",2,2,0,17,11.76,"boston"
"0","Bournemouth UA","00HN",92,0,92,92,NA,"bournemouth "
"1","Bournemouth UA","00HN",8,0,8,100,8.7,"bournemouth "
"2","Bournemouth UA","00HN",2,3,-1,99,2,"bournemouth "
"3","Bournemouth UA","00HN",3,6,-3,96,3.03,"bournemouth "
"0","Bracknell Forest UA","00MA",25,0,25,25,NA,"bracknell forest "
"0","Bradford","00CX",119,0,119,119,NA,"bradford"
"1","Bradford","00CX",24,10,14,133,20.17,"bradford"
"2","Bradford","00CX",3,7,-4,129,2.26,"bradford"
"3","Bradford","00CX",1,9,-8,121,0.78,"bradford"
"0","Braintree","22UC",39,0,39,39,NA,"braintree"
"1","Braintree","22UC",11,0,11,50,28.21,"braintree"
"2","Braintree","22UC",1,1,0,50,2,"braintree"
"0","Breckland","33UB",42,0,42,42,NA,"breckland"
"1","Breckland","33UB",14,1,13,55,33.33,"breckland"
"2","Breckland","33UB",1,2,-1,54,1.82,"breckland"
"0","Brent","00AE",67,0,67,67,NA,"brent"
"1","Brent","00AE",19,8,11,78,28.36,"brent"
"2","Brent","00AE",2,7,-5,73,2.56,"brent"
"0","Brentwood","22UD",17,0,17,17,NA,"brentwood"
"1","Brentwood","22UD",3,0,3,20,17.65,"brentwood"
"2","Brentwood","22UD",2,2,0,20,10,"brentwood"
"0","Brighton and Hove UA","00ML",96,0,96,96,NA,"brighton and hove "
"1","Brighton and Hove UA","00ML",4,8,-4,92,4.17,"brighton and hove "
"2","Brighton and Hove UA","00ML",2,4,-2,90,2.17,"brighton and hove "
"3","Brighton and Hove UA","00ML",2,5,-3,87,2.22,"brighton and hove "
"0","Bristol, City of UA","00HB",130,0,130,130,NA,"bristol"
"1","Bristol, City of UA","00HB",12,16,-4,126,9.23,"bristol"
"2","Bristol, City of UA","00HB",3,14,-11,115,2.38,"bristol"
"3","Bristol, City of UA","00HB",1,4,-3,112,0.87,"bristol"
"0","Broadland","33UC",51,0,51,51,NA,"broadland"
"1","Broadland","33UC",15,7,8,59,29.41,"broadland"
"2","Broadland","33UC",3,3,0,59,5.08,"broadland"
"3","Broadland","33UC",1,0,1,60,1.69,"broadland"
"0","Bromley","00AF",65,0,65,65,NA,"bromley"
"1","Bromley","00AF",9,9,0,65,13.85,"bromley"
"2","Bromley","00AF",2,8,-6,59,3.08,"bromley"
"0","Bromsgrove","47UB",41,0,41,41,NA,"bromsgrove"
"1","Bromsgrove","47UB",1,3,-2,39,2.44,"bromsgrove"
"2","Bromsgrove","47UB",1,0,1,40,2.56,"bromsgrove"
"0","Broxbourne","26UB",15,0,15,15,NA,"broxbourne"
"1","Broxbourne","26UB",1,1,0,15,6.67,"broxbourne"
"3","Broxbourne","26UB",1,0,1,16,6.67,"broxbourne"
"0","Broxtowe","37UD",23,0,23,23,NA,"broxtowe"
"1","Broxtowe","37UD",8,5,3,26,34.78,"broxtowe"
"2","Broxtowe","37UD",1,1,0,26,3.85,"broxtowe"
"0","Burnley","30UD",31,0,31,31,NA,"burnley"
"1","Burnley","30UD",10,3,7,38,32.26,"burnley"
"2","Burnley","30UD",1,2,-1,37,2.63,"burnley"
"0","Bury","00BM",54,0,54,54,NA,"bury"
"1","Bury","00BM",13,5,8,62,24.07,"bury"
"2","Bury","00BM",2,3,-1,61,3.23,"bury"
"0","Calderdale","00CY",50,0,50,50,NA,"calderdale"
"1","Calderdale","00CY",15,6,9,59,30,"calderdale"
"2","Calderdale","00CY",1,3,-2,57,1.69,"calderdale"
"0","Cambridge","12UB",16,0,16,16,NA,"cambridge"
"1","Cambridge","12UB",2,0,2,18,12.5,"cambridge"
"0","Camden","00AG",16,0,16,16,NA,"camden"
"2","Camden","00AG",1,1,0,16,6.25,"camden"
"0","Cannock Chase","41UB",20,0,20,20,NA,"cannock chase"
"1","Cannock Chase","41UB",2,1,1,21,10,"cannock chase"
"3","Cannock Chase","41UB",2,2,0,21,9.52,"cannock chase"
"0","Canterbury","29UC",81,0,81,81,NA,"canterbury"
"1","Canterbury","29UC",3,6,-3,78,3.7,"canterbury"
"2","Canterbury","29UC",2,2,0,78,2.56,"canterbury"
"3","Canterbury","29UC",2,9,-7,71,2.56,"canterbury"
"0","Carlisle","16UD",30,0,30,30,NA,"carlisle"
"1","Carlisle","16UD",5,1,4,34,16.67,"carlisle"
"0","Castle Point","22UE",15,0,15,15,NA,"castle point"
"1","Castle Point","22UE",2,0,2,17,13.33,"castle point"
"3","Castle Point","22UE",1,1,0,17,5.88,"castle point"
"0","Central Bedfordshire UA","00KC",48,0,48,48,NA,"central bedfordshire "
"1","Central Bedfordshire UA","00KC",11,4,7,55,22.92,"central bedfordshire "
"2","Central Bedfordshire UA","00KC",1,6,-5,50,1.82,"central bedfordshire "
"3","Central Bedfordshire UA","00KC",3,1,2,52,6,"central bedfordshire "
"0","Charnwood","31UC",49,0,49,49,NA,"charnwood"
"1","Charnwood","31UC",7,4,3,52,14.29,"charnwood"
"2","Charnwood","31UC",3,2,1,53,5.77,"charnwood"
"0","Chelmsford","22UF",19,0,19,19,NA,"chelmsford"
"1","Chelmsford","22UF",4,0,4,23,21.05,"chelmsford"
"0","Cheltenham","23UB",43,0,43,43,NA,"cheltenham"
"1","Cheltenham","23UB",5,2,3,46,11.63,"cheltenham"
"2","Cheltenham","23UB",4,1,3,49,8.7,"cheltenham"
"3","Cheltenham","23UB",1,7,-6,43,2.04,"cheltenham"
"0","Cherwell","38UB",23,0,23,23,NA,"cherwell"
"1","Cherwell","38UB",8,4,4,27,34.78,"cherwell"
"3","Cherwell","38UB",1,0,1,28,3.7,"cherwell"
"0","Cheshire East UA","00EQ",97,0,97,97,NA,"cheshire east "
"1","Cheshire East UA","00EQ",6,5,1,98,6.19,"cheshire east "
"2","Cheshire East UA","00EQ",2,4,-2,96,2.04,"cheshire east "
"3","Cheshire East UA","00EQ",2,2,0,96,2.08,"cheshire east "
"0","Cheshire West and Chester UA","00EW",65,0,65,65,NA,"cheshire west and chester "
"1","Cheshire West and Chester UA","00EW",11,3,8,73,16.92,"cheshire west and chester "
"2","Cheshire West and Chester UA","00EW",3,2,1,74,4.11,"cheshire west and chester "
"3","Cheshire West and Chester UA","00EW",2,2,0,74,2.7,"cheshire west and chester "
"0","Chesterfield","17UD",38,0,38,38,NA,"chesterfield"
"1","Chesterfield","17UD",9,1,8,46,23.68,"chesterfield"
"2","Chesterfield","17UD",2,3,-1,45,4.35,"chesterfield"
"0","Chichester","45UD",43,0,43,43,NA,"chichester"
"1","Chichester","45UD",7,1,6,49,16.28,"chichester"
"2","Chichester","45UD",1,2,-1,48,2.04,"chichester"
"3","Chichester","45UD",1,2,-1,47,2.08,"chichester"
"0","Chiltern","11UC",22,0,22,22,NA,"chiltern"
"1","Chiltern","11UC",6,3,3,25,27.27,"chiltern"
"2","Chiltern","11UC",1,1,0,25,4,"chiltern"
"3","Chiltern","11UC",2,0,2,27,8,"chiltern"
"0","Chorley","30UE",26,0,26,26,NA,"chorley"
"1","Chorley","30UE",6,1,5,31,23.08,"chorley"
"3","Chorley","30UE",1,0,1,32,3.23,"chorley"
"0","Christchurch","19UC",17,0,17,17,NA,"christchurch"
"1","Christchurch","19UC",3,1,2,19,17.65,"christchurch"
"2","Christchurch","19UC",2,1,1,20,10.53,"christchurch"
"3","Christchurch","19UC",1,2,-1,19,5,"christchurch"
"0","Colchester","22UG",68,0,68,68,NA,"colchester"
"1","Colchester","22UG",15,1,14,82,22.06,"colchester"
"2","Colchester","22UG",5,0,5,87,6.1,"colchester"
"3","Colchester","22UG",2,6,-4,83,2.3,"colchester"
"0","Copeland","16UE",22,0,22,22,NA,"copeland"
"1","Copeland","16UE",2,0,2,24,9.09,"copeland"
"0","Corby","34UB",11,0,11,11,NA,"corby"
"1","Corby","34UB",3,1,2,13,27.27,"corby"
"0","Cornwall UA","00HE",225,0,225,225,NA,"cornwall "
"1","Cornwall UA","00HE",28,7,21,246,12.44,"cornwall "
"2","Cornwall UA","00HE",8,10,-2,244,3.25,"cornwall "
"3","Cornwall UA","00HE",4,12,-8,236,1.64,"cornwall "
"0","Cotswold","23UC",23,0,23,23,NA,"cotswold"
"1","Cotswold","23UC",3,4,-1,22,13.04,"cotswold"
"0","County Durham UA","00EJ",149,0,149,149,NA,"county durham "
"1","County Durham UA","00EJ",19,15,4,153,12.75,"county durham "
"2","County Durham UA","00EJ",7,14,-7,146,4.58,"county durham "
"0","Coventry","00CQ",58,0,58,58,NA,"coventry"
"1","Coventry","00CQ",17,5,12,70,29.31,"coventry"
"2","Coventry","00CQ",6,3,3,73,8.57,"coventry"
"0","Craven","36UB",19,0,19,19,NA,"craven"
"1","Craven","36UB",4,3,1,20,21.05,"craven"
"3","Craven","36UB",1,0,1,21,5,"craven"
"0","Crawley","45UE",21,0,21,21,NA,"crawley"
"1","Crawley","45UE",1,2,-1,20,4.76,"crawley"
"2","Crawley","45UE",1,3,-2,18,5,"crawley"
"0","Croydon","00AH",122,0,122,122,NA,"croydon"
"1","Croydon","00AH",31,23,8,130,25.41,"croydon"
"2","Croydon","00AH",3,7,-4,126,2.31,"croydon"
"3","Croydon","00AH",3,8,-5,121,2.38,"croydon"
"0","Dacorum","26UC",27,0,27,27,NA,"dacorum"
"1","Dacorum","26UC",2,3,-1,26,7.41,"dacorum"
"2","Dacorum","26UC",1,1,0,26,3.85,"dacorum"
"0","Darlington UA","00EH",30,0,30,30,NA,"darlington "
"1","Darlington UA","00EH",3,0,3,33,10,"darlington "
"2","Darlington UA","00EH",1,1,0,33,3.03,"darlington "
"3","Darlington UA","00EH",2,2,0,33,6.06,"darlington "
"0","Dartford","29UD",19,0,19,19,NA,"dartford"
"1","Dartford","29UD",2,2,0,19,10.53,"dartford"
"2","Dartford","29UD",1,1,0,19,5.26,"dartford"
"3","Dartford","29UD",1,0,1,20,5.26,"dartford"
"0","Daventry","34UC",16,0,16,16,NA,"daventry"
"1","Daventry","34UC",3,0,3,19,18.75,"daventry"
"3","Daventry","34UC",2,1,1,20,10.53,"daventry"
"0","Derby UA","00FK",53,0,53,53,NA,"derby "
"1","Derby UA","00FK",25,1,24,77,47.17,"derby "
"2","Derby UA","00FK",2,4,-2,75,2.6,"derby "
"3","Derby UA","00FK",4,3,1,76,5.33,"derby "
"0","Derbyshire Dales","17UF",23,0,23,23,NA,"derbyshire dales"
"1","Derbyshire Dales","17UF",2,1,1,24,8.7,"derbyshire dales"
"2","Derbyshire Dales","17UF",1,0,1,25,4.17,"derbyshire dales"
"3","Derbyshire Dales","17UF",1,2,-1,24,4,"derbyshire dales"
"0","Doncaster","00CE",72,0,72,72,NA,"doncaster"
"1","Doncaster","00CE",14,3,11,83,19.44,"doncaster"
"2","Doncaster","00CE",8,4,4,87,9.64,"doncaster"
"3","Doncaster","00CE",1,2,-1,86,1.15,"doncaster"
"0","Dover","29UE",74,0,74,74,NA,"dover"
"1","Dover","29UE",7,5,2,76,9.46,"dover"
"2","Dover","29UE",2,4,-2,74,2.63,"dover"
"0","Dudley","00CR",95,0,95,95,NA,"dudley"
"1","Dudley","00CR",6,7,-1,94,6.32,"dudley"
"2","Dudley","00CR",3,8,-5,89,3.19,"dudley"
"0","Ealing","00AJ",57,0,57,57,NA,"ealing"
"1","Ealing","00AJ",4,0,4,61,7.02,"ealing"
"2","Ealing","00AJ",1,3,-2,59,1.64,"ealing"
"3","Ealing","00AJ",1,8,-7,52,1.69,"ealing"
"0","East Cambridgeshire","12UC",18,0,18,18,NA,"east cambridgeshire"
"1","East Cambridgeshire","12UC",1,1,0,18,5.56,"east cambridgeshire"
"0","East Devon","18UB",83,0,83,83,NA,"east devon"
"1","East Devon","18UB",8,8,0,83,9.64,"east devon"
"0","East Dorset","19UD",30,0,30,30,NA,"east dorset"
"1","East Dorset","19UD",1,1,0,30,3.33,"east dorset"
"2","East Dorset","19UD",1,3,-2,28,3.33,"east dorset"
"0","East Hampshire","24UC",63,0,63,63,NA,"east hampshire"
"1","East Hampshire","24UC",2,4,-2,61,3.17,"east hampshire"
"2","East Hampshire","24UC",1,2,-1,60,1.64,"east hampshire"
"0","East Hertfordshire","26UD",21,0,21,21,NA,"east hertfordshire"
"1","East Hertfordshire","26UD",3,1,2,23,14.29,"east hertfordshire"
"2","East Hertfordshire","26UD",1,0,1,24,4.35,"east hertfordshire"
"3","East Hertfordshire","26UD",1,1,0,24,4.17,"east hertfordshire"
"0","East Lindsey","32UC",63,0,63,63,NA,"east lindsey"
"1","East Lindsey","32UC",17,3,14,77,26.98,"east lindsey"
"0","East Northamptonshire","34UD",31,0,31,31,NA,"east northamptonshire"
"1","East Northamptonshire","34UD",8,3,5,36,25.81,"east northamptonshire"
"3","East Northamptonshire","34UD",1,1,0,36,2.78,"east northamptonshire"
"0","East Riding of Yorkshire UA","00FB",128,0,128,128,NA,"east riding of yorkshire "
"1","East Riding of Yorkshire UA","00FB",22,11,11,139,17.19,"east riding of yorkshire "
"2","East Riding of Yorkshire UA","00FB",3,2,1,140,2.16,"east riding of yorkshire "
"3","East Riding of Yorkshire UA","00FB",1,5,-4,136,0.71,"east riding of yorkshire "
"0","East Staffordshire","41UC",31,0,31,31,NA,"east staffordshire"
"1","East Staffordshire","41UC",1,0,1,32,3.23,"east staffordshire"
"2","East Staffordshire","41UC",2,0,2,34,6.25,"east staffordshire"
"3","East Staffordshire","41UC",2,0,2,36,5.88,"east staffordshire"
"0","Eastbourne","21UC",60,0,60,60,NA,"eastbourne"
"1","Eastbourne","21UC",5,0,5,65,8.33,"eastbourne"
"0","Eastleigh","24UD",45,0,45,45,NA,"eastleigh"
"1","Eastleigh","24UD",3,1,2,47,6.67,"eastleigh"
"2","Eastleigh","24UD",1,3,-2,45,2.13,"eastleigh"
"3","Eastleigh","24UD",2,1,1,46,4.44,"eastleigh"
"0","Eden","16UF",15,0,15,15,NA,"eden"
"1","Eden","16UF",2,0,2,17,13.33,"eden"
"3","Eden","16UF",1,1,0,17,5.88,"eden"
"0","Elmbridge","43UB",32,0,32,32,NA,"elmbridge"
"1","Elmbridge","43UB",6,2,4,36,18.75,"elmbridge"
"3","Elmbridge","43UB",2,1,1,37,5.56,"elmbridge"
"0","Enfield","00AK",89,0,89,89,NA,"enfield"
"1","Enfield","00AK",8,6,2,91,8.99,"enfield"
"2","Enfield","00AK",2,1,1,92,2.2,"enfield"
"3","Enfield","00AK",1,5,-4,88,1.09,"enfield"
"0","Epping Forest","22UH",28,0,28,28,NA,"epping forest"
"1","Epping Forest","22UH",3,2,1,29,10.71,"epping forest"
"0","Epsom and Ewell","43UC",23,0,23,23,NA,"epsom and ewell"
"1","Epsom and Ewell","43UC",4,2,2,25,17.39,"epsom and ewell"
"3","Epsom and Ewell","43UC",1,2,-1,24,4,"epsom and ewell"
"0","Erewash","17UG",34,0,34,34,NA,"erewash"
"1","Erewash","17UG",5,0,5,39,14.71,"erewash"
"2","Erewash","17UG",3,3,0,39,7.69,"erewash"
"3","Erewash","17UG",1,3,-2,37,2.56,"erewash"
"0","Exeter","18UC",44,0,44,44,NA,"exeter"
"1","Exeter","18UC",4,4,0,44,9.09,"exeter"
"2","Exeter","18UC",1,4,-3,41,2.27,"exeter"
"3","Exeter","18UC",2,5,-3,38,4.88,"exeter"
"0","Fareham","24UE",50,0,50,50,NA,"fareham"
"1","Fareham","24UE",9,3,6,56,18,"fareham"
"2","Fareham","24UE",2,4,-2,54,3.57,"fareham"
"3","Fareham","24UE",2,1,1,55,3.7,"fareham"
"0","Fenland","12UD",32,0,32,32,NA,"fenland"
"1","Fenland","12UD",3,4,-1,31,9.38,"fenland"
"0","Forest Heath","42UC",7,0,7,7,NA,"forest heath"
"1","Forest Heath","42UC",2,0,2,9,28.57,"forest heath"
"2","Forest Heath","42UC",2,3,-1,8,22.22,"forest heath"
"0","Forest of Dean","23UD",46,1,45,45,NA,"forest of dean"
"1","Forest of Dean","23UD",3,2,1,46,6.67,"forest of dean"
"3","Forest of Dean","23UD",1,1,0,46,2.17,"forest of dean"
"0","Fylde","30UF",46,0,46,46,NA,"fylde"
"1","Fylde","30UF",9,7,2,48,19.57,"fylde"
"0","Gateshead","00CH",66,0,66,66,NA,"gateshead"
"1","Gateshead","00CH",12,5,7,73,18.18,"gateshead"
"2","Gateshead","00CH",1,5,-4,69,1.37,"gateshead"
"3","Gateshead","00CH",1,2,-1,68,1.45,"gateshead"
"0","Gedling","37UE",28,0,28,28,NA,"gedling"
"1","Gedling","37UE",13,4,9,37,46.43,"gedling"
"2","Gedling","37UE",1,1,0,37,2.7,"gedling"
"3","Gedling","37UE",1,1,0,37,2.7,"gedling"
"0","Gloucester","23UE",55,0,55,55,NA,"gloucester"
"1","Gloucester","23UE",5,4,1,56,9.09,"gloucester"
"2","Gloucester","23UE",1,0,1,57,1.79,"gloucester"
"3","Gloucester","23UE",1,0,1,58,1.75,"gloucester"
"0","Gosport","24UF",33,0,33,33,NA,"gosport"
"1","Gosport","24UF",4,3,1,34,12.12,"gosport"
"2","Gosport","24UF",2,3,-1,33,5.88,"gosport"
"3","Gosport","24UF",2,0,2,35,6.06,"gosport"
"0","Gravesham","29UG",22,0,22,22,NA,"gravesham"
"1","Gravesham","29UG",1,0,1,23,4.55,"gravesham"
"2","Gravesham","29UG",3,2,1,24,13.04,"gravesham"
"0","Great Yarmouth","33UD",33,0,33,33,NA,"great yarmouth"
"1","Great Yarmouth","33UD",8,0,8,41,24.24,"great yarmouth"
"2","Great Yarmouth","33UD",6,3,3,44,14.63,"great yarmouth"
"3","Great Yarmouth","33UD",4,3,1,45,9.09,"great yarmouth"
"0","Greenwich","00AL",32,0,32,32,NA,"greenwich"
"1","Greenwich","00AL",12,4,8,40,37.5,"greenwich"
"2","Greenwich","00AL",5,4,1,41,12.5,"greenwich"
"3","Greenwich","00AL",2,1,1,42,4.88,"greenwich"
"0","Guildford","43UD",33,0,33,33,NA,"guildford"
"1","Guildford","43UD",6,3,3,36,18.18,"guildford"
"2","Guildford","43UD",2,3,-1,35,5.56,"guildford"
"0","Hackney","00AM",25,0,25,25,NA,"hackney"
"1","Hackney","00AM",9,6,3,28,36,"hackney"
"0","Halton UA","00ET",30,0,30,30,NA,"halton "
"1","Halton UA","00ET",2,0,2,32,6.67,"halton "
"0","Hambleton","36UC",15,0,15,15,NA,"hambleton"
"1","Hambleton","36UC",1,0,1,16,6.67,"hambleton"
"2","Hambleton","36UC",1,1,0,16,6.25,"hambleton"
"3","Hambleton","36UC",2,0,2,18,12.5,"hambleton"
"0","Hammersmith and Fulham","00AN",21,0,21,21,NA,"hammersmith and fulham"
"0","Harborough","31UD",20,0,20,20,NA,"harborough"
"1","Harborough","31UD",2,2,0,20,10,"harborough"
"2","Harborough","31UD",1,2,-1,19,5,"harborough"
"0","Haringey","00AP",68,0,68,68,NA,"haringey"
"1","Haringey","00AP",11,16,-5,63,16.18,"haringey"
"3","Haringey","00AP",1,8,-7,56,1.59,"haringey"
"0","Harlow","22UJ",8,0,8,8,NA,"harlow"
"1","Harlow","22UJ",1,1,0,8,12.5,"harlow"
"0","Harrogate","36UD",66,0,66,66,NA,"harrogate"
"1","Harrogate","36UD",12,4,8,74,18.18,"harrogate"
"3","Harrogate","36UD",4,6,-2,72,5.41,"harrogate"
"0","Harrow","00AQ",64,0,64,64,NA,"harrow"
"1","Harrow","00AQ",9,4,5,69,14.06,"harrow"
"3","Harrow","00AQ",2,5,-3,66,2.9,"harrow"
"0","Hart","24UG",14,0,14,14,NA,"hart"
"1","Hart","24UG",1,1,0,14,7.14,"hart"
"2","Hart","24UG",1,1,0,14,7.14,"hart"
"3","Hart","24UG",1,0,1,15,7.14,"hart"
"0","Hartlepool UA","00EB",24,0,24,24,NA,"hartlepool "
"1","Hartlepool UA","00EB",4,1,3,27,16.67,"hartlepool "
"3","Hartlepool UA","00EB",1,3,-2,25,3.7,"hartlepool "
"0","Hastings","21UD",62,0,62,62,NA,"hastings"
"1","Hastings","21UD",4,6,-2,60,6.45,"hastings"
"2","Hastings","21UD",2,4,-2,58,3.33,"hastings"
"0","Havant","24UH",52,0,52,52,NA,"havant"
"1","Havant","24UH",5,2,3,55,9.62,"havant"
"2","Havant","24UH",1,1,0,55,1.82,"havant"
"3","Havant","24UH",2,3,-1,54,3.64,"havant"
"0","Havering","00AR",52,0,52,52,NA,"havering"
"1","Havering","00AR",17,4,13,65,32.69,"havering"
"2","Havering","00AR",3,5,-2,63,4.62,"havering"
"0","Herefordshire, County of UA","00GA",75,0,75,75,NA,"herefordshire "
"1","Herefordshire, County of UA","00GA",12,4,8,83,16,"herefordshire "
"0","Hertsmere","26UE",30,0,30,30,NA,"hertsmere"
"1","Hertsmere","26UE",5,1,4,34,16.67,"hertsmere"
"0","High Peak","17UH",25,0,25,25,NA,"high peak"
"1","High Peak","17UH",1,1,0,25,4,"high peak"
"2","High Peak","17UH",5,1,4,29,20,"high peak"
"0","Hillingdon","00AS",48,0,48,48,NA,"hillingdon"
"1","Hillingdon","00AS",10,0,10,58,20.83,"hillingdon"
"2","Hillingdon","00AS",3,4,-1,57,5.17,"hillingdon"
"3","Hillingdon","00AS",4,10,-6,51,7.02,"hillingdon"
"0","Hinckley and Bosworth","31UE",26,0,26,26,NA,"hinckley and bosworth"
"1","Hinckley and Bosworth","31UE",3,1,2,28,11.54,"hinckley and bosworth"
"2","Hinckley and Bosworth","31UE",2,2,0,28,7.14,"hinckley and bosworth"
"0","Horsham","45UF",30,0,30,30,NA,"horsham"
"1","Horsham","45UF",6,2,4,34,20,"horsham"
"3","Horsham","45UF",1,0,1,35,2.94,"horsham"
"0","Hounslow","00AT",24,0,24,24,NA,"hounslow"
"1","Hounslow","00AT",9,4,5,29,37.5,"hounslow"
"3","Hounslow","00AT",1,2,-1,28,3.45,"hounslow"
"0","Huntingdonshire","12UE",30,0,30,30,NA,"huntingdonshire"
"1","Huntingdonshire","12UE",2,0,2,32,6.67,"huntingdonshire"
"2","Huntingdonshire","12UE",1,1,0,32,3.12,"huntingdonshire"
"3","Huntingdonshire","12UE",2,0,2,34,6.25,"huntingdonshire"
"0","Hyndburn","30UG",28,0,28,28,NA,"hyndburn"
"1","Hyndburn","30UG",8,0,8,36,28.57,"hyndburn"
"2","Hyndburn","30UG",1,0,1,37,2.78,"hyndburn"
"0","Ipswich","42UD",27,0,27,27,NA,"ipswich"
"1","Ipswich","42UD",1,1,0,27,3.7,"ipswich"
"2","Ipswich","42UD",2,2,0,27,7.41,"ipswich"
"3","Ipswich","42UD",2,3,-1,26,7.41,"ipswich"
"0","Isle of Wight UA","00MW",87,0,87,87,NA,"isle of wight "
"1","Isle of Wight UA","00MW",6,4,2,89,6.9,"isle of wight "
"3","Isle of Wight UA","00MW",1,2,-1,88,1.12,"isle of wight "
"0","Isles of Scilly UA","00HF",1,0,1,1,NA,"isles of scilly "
"0","Islington","00AU",18,0,18,18,NA,"islington"
"1","Islington","00AU",7,4,3,21,38.89,"islington"
"0","Kensington and Chelsea","00AW",13,0,13,13,NA,"kensington and chelsea"
"1","Kensington and Chelsea","00AW",3,3,0,13,23.08,"kensington and chelsea"
"0","Kettering","34UE",36,0,36,36,NA,"kettering"
"1","Kettering","34UE",7,1,6,42,19.44,"kettering"
"3","Kettering","34UE",2,0,2,44,4.76,"kettering"
"0","King's Lynn and West Norfolk","33UE",45,0,45,45,NA,"king's lynn and west norfolk"
"1","King's Lynn and West Norfolk","33UE",9,3,6,51,20,"king's lynn and west norfolk"
"2","King's Lynn and West Norfolk","33UE",1,3,-2,49,1.96,"king's lynn and west norfolk"
"3","King's Lynn and West Norfolk","33UE",1,1,0,49,2.04,"king's lynn and west norfolk"
"0","Kingston upon Hull, City of UA","00FA",69,0,69,69,NA,"kingston upon hull"
"1","Kingston upon Hull, City of UA","00FA",16,3,13,82,23.19,"kingston upon hull"
"2","Kingston upon Hull, City of UA","00FA",4,2,2,84,4.88,"kingston upon hull"
"3","Kingston upon Hull, City of UA","00FA",1,4,-3,81,1.19,"kingston upon hull"
"0","Kingston upon Thames","00AX",44,0,44,44,NA,"kingston upon thames"
"1","Kingston upon Thames","00AX",4,4,0,44,9.09,"kingston upon thames"
"2","Kingston upon Thames","00AX",4,7,-3,41,9.09,"kingston upon thames"
"3","Kingston upon Thames","00AX",2,5,-3,38,4.88,"kingston upon thames"
"0","Kirklees","00CZ",87,0,87,87,NA,"kirklees"
"1","Kirklees","00CZ",34,3,31,118,39.08,"kirklees"
"2","Kirklees","00CZ",3,2,1,119,2.54,"kirklees"
"3","Kirklees","00CZ",3,7,-4,115,2.52,"kirklees"
"0","Knowsley","00BX",27,0,27,27,NA,"knowsley"
"1","Knowsley","00BX",3,1,2,29,11.11,"knowsley"
"0","Lambeth","00AY",58,0,58,58,NA,"lambeth"
"1","Lambeth","00AY",7,12,-5,53,12.07,"lambeth"
"2","Lambeth","00AY",5,8,-3,50,9.43,"lambeth"
"3","Lambeth","00AY",1,5,-4,46,2,"lambeth"
"0","Lancaster","30UH",44,0,44,44,NA,"lancaster"
"1","Lancaster","30UH",16,2,14,58,36.36,"lancaster"
"2","Lancaster","30UH",1,3,-2,56,1.72,"lancaster"
"0","Leeds","00DA",127,0,127,127,NA,"leeds"
"1","Leeds","00DA",44,10,34,161,34.65,"leeds"
"2","Leeds","00DA",4,18,-14,147,2.48,"leeds"
"3","Leeds","00DA",7,3,4,151,4.76,"leeds"
"0","Leicester UA","00FN",89,0,89,89,NA,"leicester "
"1","Leicester UA","00FN",14,2,12,101,15.73,"leicester "
"2","Leicester UA","00FN",5,5,0,101,4.95,"leicester "
"3","Leicester UA","00FN",2,5,-3,98,1.98,"leicester "
"0","Lewes","21UF",42,0,42,42,NA,"lewes"
"1","Lewes","21UF",4,3,1,43,9.52,"lewes"
"2","Lewes","21UF",2,5,-3,40,4.65,"lewes"
"0","Lewisham","00AZ",57,0,57,57,NA,"lewisham"
"1","Lewisham","00AZ",4,3,1,58,7.02,"lewisham"
"2","Lewisham","00AZ",4,6,-2,56,6.9,"lewisham"
"3","Lewisham","00AZ",3,6,-3,53,5.36,"lewisham"
"0","Lichfield","41UD",25,0,25,25,NA,"lichfield"
"1","Lichfield","41UD",4,0,4,29,16,"lichfield"
"3","Lichfield","41UD",3,2,1,30,10.34,"lichfield"
"0","Lincoln","32UD",27,0,27,27,NA,"lincoln"
"1","Lincoln","32UD",2,3,-1,26,7.41,"lincoln"
"2","Lincoln","32UD",2,1,1,27,7.69,"lincoln"
"0","Liverpool","00BY",99,0,99,99,NA,"liverpool"
"1","Liverpool","00BY",10,7,3,102,10.1,"liverpool"
"2","Liverpool","00BY",4,9,-5,97,3.92,"liverpool"
"3","Liverpool","00BY",3,14,-11,86,3.09,"liverpool"
"0","Luton UA","00KA",37,0,37,37,NA,"luton "
"1","Luton UA","00KA",9,7,2,39,24.32,"luton "
"2","Luton UA","00KA",1,4,-3,36,2.56,"luton "
"3","Luton UA","00KA",1,2,-1,35,2.78,"luton "
"0","Maidstone","29UH",46,0,46,46,NA,"maidstone"
"1","Maidstone","29UH",5,5,0,46,10.87,"maidstone"
"2","Maidstone","29UH",1,3,-2,44,2.17,"maidstone"
"3","Maidstone","29UH",1,3,-2,42,2.27,"maidstone"
"0","Maldon","22UK",21,0,21,21,NA,"maldon"
"1","Maldon","22UK",1,1,0,21,4.76,"maldon"
"0","Malvern Hills","47UC",34,0,34,34,NA,"malvern hills"
"1","Malvern Hills","47UC",8,2,6,40,23.53,"malvern hills"
"3","Malvern Hills","47UC",1,4,-3,37,2.5,"malvern hills"
"0","Manchester","00BN",87,0,87,87,NA,"manchester"
"1","Manchester","00BN",18,8,10,97,20.69,"manchester"
"2","Manchester","00BN",4,7,-3,94,4.12,"manchester"
"3","Manchester","00BN",2,13,-11,83,2.13,"manchester"
"0","Mansfield","37UF",28,0,28,28,NA,"mansfield"
"1","Mansfield","37UF",7,0,7,35,25,"mansfield"
"2","Mansfield","37UF",3,4,-1,34,8.57,"mansfield"
"0","Medway UA","00LC",71,0,71,71,NA,"medway "
"1","Medway UA","00LC",14,9,5,76,19.72,"medway "
"2","Medway UA","00LC",2,7,-5,71,2.63,"medway "
"0","Melton","31UG",10,0,10,10,NA,"melton"
"0","Mendip","40UB",36,0,36,36,NA,"mendip"
"1","Mendip","40UB",1,0,1,37,2.78,"mendip"
"2","Mendip","40UB",1,0,1,38,2.7,"mendip"
"0","Merton","00BA",44,0,44,44,NA,"merton"
"1","Merton","00BA",8,3,5,49,18.18,"merton"
"3","Merton","00BA",1,2,-1,48,2.04,"merton"
"0","Mid Devon","18UD",36,0,36,36,NA,"mid devon"
"1","Mid Devon","18UD",2,3,-1,35,5.56,"mid devon"
"2","Mid Devon","18UD",2,3,-1,34,5.71,"mid devon"
"3","Mid Devon","18UD",1,3,-2,32,2.94,"mid devon"
"0","Mid Suffolk","42UE",18,0,18,18,NA,"mid suffolk"
"1","Mid Suffolk","42UE",10,6,4,22,55.56,"mid suffolk"
"3","Mid Suffolk","42UE",2,2,0,22,9.09,"mid suffolk"
"0","Mid Sussex","45UG",47,0,47,47,NA,"mid sussex"
"1","Mid Sussex","45UG",6,0,6,53,12.77,"mid sussex"
"2","Mid Sussex","45UG",1,0,1,54,1.89,"mid sussex"
"0","Middlesbrough UA","00EC",35,0,35,35,NA,"middlesbrough "
"1","Middlesbrough UA","00EC",15,4,11,46,42.86,"middlesbrough "
"2","Middlesbrough UA","00EC",1,2,-1,45,2.17,"middlesbrough "
"0","Milton Keynes UA","00MG",45,0,45,45,NA,"milton keynes "
"1","Milton Keynes UA","00MG",8,4,4,49,17.78,"milton keynes "
"2","Milton Keynes UA","00MG",1,3,-2,47,2.04,"milton keynes "
"3","Milton Keynes UA","00MG",2,0,2,49,4.26,"milton keynes "
"0","Mole Valley","43UE",34,0,34,34,NA,"mole valley"
"1","Mole Valley","43UE",4,3,1,35,11.76,"mole valley"
"2","Mole Valley","43UE",1,1,0,35,2.86,"mole valley"
"0","New Forest","24UJ",85,0,85,85,NA,"new forest"
"1","New Forest","24UJ",13,5,8,93,15.29,"new forest"
"2","New Forest","24UJ",5,5,0,93,5.38,"new forest"
"0","Newark and Sherwood","37UG",33,0,33,33,NA,"newark and sherwood"
"1","Newark and Sherwood","37UG",13,2,11,44,39.39,"newark and sherwood"
"2","Newark and Sherwood","37UG",3,6,-3,41,6.82,"newark and sherwood"
"3","Newark and Sherwood","37UG",2,1,1,42,4.88,"newark and sherwood"
"0","Newcastle upon Tyne","00CJ",57,0,57,57,NA,"newcastle upon tyne"
"1","Newcastle upon Tyne","00CJ",15,8,7,64,26.32,"newcastle upon tyne"
"2","Newcastle upon Tyne","00CJ",2,4,-2,62,3.12,"newcastle upon tyne"
"3","Newcastle upon Tyne","00CJ",1,3,-2,60,1.61,"newcastle upon tyne"
"0","Newcastle-under-Lyme","41UE",35,0,35,35,NA,"newcastle-under-lyme"
"1","Newcastle-under-Lyme","41UE",3,0,3,38,8.57,"newcastle-under-lyme"
"3","Newcastle-under-Lyme","41UE",1,2,-1,37,2.63,"newcastle-under-lyme"
"0","Newham","00BB",32,0,32,32,NA,"newham"
"1","Newham","00BB",17,11,6,38,53.12,"newham"
"2","Newham","00BB",2,7,-5,33,5.26,"newham"
"3","Newham","00BB",1,4,-3,30,3.03,"newham"
"0","North Devon","18UE",38,0,38,38,NA,"north devon"
"1","North Devon","18UE",4,1,3,41,10.53,"north devon"
"0","North Dorset","19UE",20,0,20,20,NA,"north dorset"
"1","North Dorset","19UE",5,0,5,25,25,"north dorset"
"0","North East Derbyshire","17UJ",27,0,27,27,NA,"north east derbyshire"
"1","North East Derbyshire","17UJ",2,1,1,28,7.41,"north east derbyshire"
"3","North East Derbyshire","17UJ",2,0,2,30,7.14,"north east derbyshire"
"0","North East Lincolnshire UA","00FC",49,0,49,49,NA,"north east lincolnshire "
"1","North East Lincolnshire UA","00FC",14,5,9,58,28.57,"north east lincolnshire "
"2","North East Lincolnshire UA","00FC",1,6,-5,53,1.72,"north east lincolnshire "
"3","North East Lincolnshire UA","00FC",1,3,-2,51,1.89,"north east lincolnshire "
"0","North Hertfordshire","26UF",32,0,32,32,NA,"north hertfordshire"
"1","North Hertfordshire","26UF",3,3,0,32,9.38,"north hertfordshire"
"2","North Hertfordshire","26UF",1,0,1,33,3.12,"north hertfordshire"
"3","North Hertfordshire","26UF",2,3,-1,32,6.06,"north hertfordshire"
"0","North Kesteven","32UE",37,0,37,37,NA,"north kesteven"
"1","North Kesteven","32UE",3,2,1,38,8.11,"north kesteven"
"3","North Kesteven","32UE",1,0,1,39,2.63,"north kesteven"
"0","North Lincolnshire UA","00FD",50,0,50,50,NA,"north lincolnshire "
"1","North Lincolnshire UA","00FD",12,3,9,59,24,"north lincolnshire "
"2","North Lincolnshire UA","00FD",2,0,2,61,3.39,"north lincolnshire "
"0","North Norfolk","33UF",57,0,57,57,NA,"north norfolk"
"1","North Norfolk","33UF",13,3,10,67,22.81,"north norfolk"
"2","North Norfolk","33UF",3,3,0,67,4.48,"north norfolk"
"3","North Norfolk","33UF",1,2,-1,66,1.49,"north norfolk"
"0","North Somerset UA","00HC",105,0,105,105,NA,"north somerset "
"1","North Somerset UA","00HC",10,7,3,108,9.52,"north somerset "
"2","North Somerset UA","00HC",1,8,-7,101,0.93,"north somerset "
"0","North Tyneside","00CK",63,0,63,63,NA,"north tyneside"
"1","North Tyneside","00CK",7,11,-4,59,11.11,"north tyneside"
"2","North Tyneside","00CK",2,6,-4,55,3.39,"north tyneside"
"3","North Tyneside","00CK",3,7,-4,51,5.45,"north tyneside"
"0","North Warwickshire","44UB",20,0,20,20,NA,"north warwickshire"
"1","North Warwickshire","44UB",4,1,3,23,20,"north warwickshire"
"2","North Warwickshire","44UB",1,0,1,24,4.35,"north warwickshire"
"0","North West Leicestershire","31UH",21,0,21,21,NA,"north west leicestershire"
"1","North West Leicestershire","31UH",1,1,0,21,4.76,"north west leicestershire"
"2","North West Leicestershire","31UH",2,2,0,21,9.52,"north west leicestershire"
"0","Northampton","34UF",57,0,57,57,NA,"northampton"
"1","Northampton","34UF",23,8,15,72,40.35,"northampton"
"2","Northampton","34UF",8,7,1,73,11.11,"northampton"
"3","Northampton","34UF",1,9,-8,65,1.37,"northampton"
"0","Northumberland UA","00EM",127,0,127,127,NA,"northumberland "
"1","Northumberland UA","00EM",12,10,2,129,9.45,"northumberland "
"2","Northumberland UA","00EM",7,16,-9,120,5.43,"northumberland "
"3","Northumberland UA","00EM",2,13,-11,109,1.67,"northumberland "
"0","Norwich","33UG",29,0,29,29,NA,"norwich"
"1","Norwich","33UG",8,2,6,35,27.59,"norwich"
"3","Norwich","33UG",2,1,1,36,5.71,"norwich"
"0","Nottingham UA","00FY",68,0,68,68,NA,"nottingham "
"1","Nottingham UA","00FY",17,8,9,77,25,"nottingham "
"2","Nottingham UA","00FY",9,2,7,84,11.69,"nottingham "
"3","Nottingham UA","00FY",2,6,-4,80,2.38,"nottingham "
"0","Nuneaton and Bedworth","44UC",29,0,29,29,NA,"nuneaton and bedworth"
"1","Nuneaton and Bedworth","44UC",9,3,6,35,31.03,"nuneaton and bedworth"
"2","Nuneaton and Bedworth","44UC",4,2,2,37,11.43,"nuneaton and bedworth"
"3","Nuneaton and Bedworth","44UC",1,2,-1,36,2.7,"nuneaton and bedworth"
"0","Oadby and Wigston","31UJ",16,0,16,16,NA,"oadby and wigston"
"1","Oadby and Wigston","31UJ",1,0,1,17,6.25,"oadby and wigston"
"2","Oadby and Wigston","31UJ",1,3,-2,15,5.88,"oadby and wigston"
"0","Oldham","00BP",40,0,40,40,NA,"oldham"
"1","Oldham","00BP",2,2,0,40,5,"oldham"
"0","Oxford","38UC",16,0,16,16,NA,"oxford"
"1","Oxford","38UC",4,0,4,20,25,"oxford"
"0","Pendle","30UJ",26,0,26,26,NA,"pendle"
"1","Pendle","30UJ",3,0,3,29,11.54,"pendle"
"2","Pendle","30UJ",1,6,-5,24,3.45,"pendle"
"0","Peterborough UA","00JA",28,0,28,28,NA,"peterborough "
"1","Peterborough UA","00JA",7,4,3,31,25,"peterborough "
"3","Peterborough UA","00JA",2,3,-1,30,6.45,"peterborough "
"0","Plymouth UA","00HG",105,0,105,105,NA,"plymouth "
"1","Plymouth UA","00HG",14,18,-4,101,13.33,"plymouth "
"3","Plymouth UA","00HG",2,3,-1,100,1.98,"plymouth "
"0","Poole UA","00HP",39,0,39,39,NA,"poole "
"1","Poole UA","00HP",11,0,11,50,28.21,"poole "
"3","Poole UA","00HP",1,5,-4,46,2,"poole "
"0","Portsmouth UA","00MR",43,0,43,43,NA,"portsmouth "
"1","Portsmouth UA","00MR",5,2,3,46,11.63,"portsmouth "
"2","Portsmouth UA","00MR",1,3,-2,44,2.17,"portsmouth "
"3","Portsmouth UA","00MR",3,4,-1,43,6.82,"portsmouth "
"0","Preston","30UK",32,0,32,32,NA,"preston"
"1","Preston","30UK",5,1,4,36,15.62,"preston"
"2","Preston","30UK",1,1,0,36,2.78,"preston"
"3","Preston","30UK",3,3,0,36,8.33,"preston"
"0","Purbeck","19UG",11,0,11,11,NA,"purbeck"
"1","Purbeck","19UG",4,2,2,13,36.36,"purbeck"
"3","Purbeck","19UG",1,3,-2,11,7.69,"purbeck"
"0","Reading UA","00MC",33,0,33,33,NA,"reading "
"1","Reading UA","00MC",11,3,8,41,33.33,"reading "
"2","Reading UA","00MC",2,1,1,42,4.88,"reading "
"0","Redbridge","00BC",63,0,63,63,NA,"redbridge"
"1","Redbridge","00BC",19,6,13,76,30.16,"redbridge"
"2","Redbridge","00BC",4,8,-4,72,5.26,"redbridge"
"3","Redbridge","00BC",3,2,1,73,4.17,"redbridge"
"0","Redcar and Cleveland UA","00EE",49,0,49,49,NA,"redcar and cleveland "
"1","Redcar and Cleveland UA","00EE",7,4,3,52,14.29,"redcar and cleveland "
"2","Redcar and Cleveland UA","00EE",2,2,0,52,3.85,"redcar and cleveland "
"3","Redcar and Cleveland UA","00EE",2,2,0,52,3.85,"redcar and cleveland "
"0","Redditch","47UD",13,0,13,13,NA,"redditch"
"1","Redditch","47UD",5,2,3,16,38.46,"redditch"
"0","Reigate and Banstead","43UF",86,0,86,86,NA,"reigate and banstead"
"1","Reigate and Banstead","43UF",16,9,7,93,18.6,"reigate and banstead"
"2","Reigate and Banstead","43UF",3,1,2,95,3.23,"reigate and banstead"
"3","Reigate and Banstead","43UF",1,4,-3,92,1.05,"reigate and banstead"
"0","Ribble Valley","30UL",15,0,15,15,NA,"ribble valley"
"1","Ribble Valley","30UL",5,0,5,20,33.33,"ribble valley"
"3","Ribble Valley","30UL",1,0,1,21,5,"ribble valley"
"0","Richmond upon Thames","00BD",40,0,40,40,NA,"richmond upon thames"
"1","Richmond upon Thames","00BD",11,3,8,48,27.5,"richmond upon thames"
"0","Richmondshire","36UE",8,0,8,8,NA,"richmondshire"
"1","Richmondshire","36UE",1,1,0,8,12.5,"richmondshire"
"0","Rochdale","00BQ",54,0,54,54,NA,"rochdale"
"1","Rochdale","00BQ",9,6,3,57,16.67,"rochdale"
"2","Rochdale","00BQ",6,4,2,59,10.53,"rochdale"
"3","Rochdale","00BQ",2,5,-3,56,3.39,"rochdale"
"0","Rochford","22UL",15,0,15,15,NA,"rochford"
"1","Rochford","22UL",1,0,1,16,6.67,"rochford"
"0","Rossendale","30UM",27,0,27,27,NA,"rossendale"
"1","Rossendale","30UM",6,1,5,32,22.22,"rossendale"
"2","Rossendale","30UM",1,0,1,33,3.12,"rossendale"
"0","Rother","21UG",71,0,71,71,NA,"rother"
"1","Rother","21UG",2,5,-3,68,2.82,"rother"
"0","Rotherham","00CF",67,0,67,67,NA,"rotherham"
"1","Rotherham","00CF",19,2,17,84,28.36,"rotherham"
"2","Rotherham","00CF",3,3,0,84,3.57,"rotherham"
"3","Rotherham","00CF",2,3,-1,83,2.38,"rotherham"
"0","Rugby","44UD",25,0,25,25,NA,"rugby"
"1","Rugby","44UD",5,3,2,27,20,"rugby"
"2","Rugby","44UD",2,4,-2,25,7.41,"rugby"
"3","Rugby","44UD",1,0,1,26,4,"rugby"
"0","Runnymede","43UG",26,0,26,26,NA,"runnymede"
"1","Runnymede","43UG",3,5,-2,24,11.54,"runnymede"
"0","Rushcliffe","37UJ",31,0,31,31,NA,"rushcliffe"
"1","Rushcliffe","37UJ",11,2,9,40,35.48,"rushcliffe"
"2","Rushcliffe","37UJ",2,3,-1,39,5,"rushcliffe"
"3","Rushcliffe","37UJ",2,2,0,39,5.13,"rushcliffe"
"0","Rushmoor","24UL",23,0,23,23,NA,"rushmoor"
"1","Rushmoor","24UL",3,1,2,25,13.04,"rushmoor"
"0","Rutland UA","00FP",12,0,12,12,NA,"rutland "
"1","Rutland UA","00FP",2,0,2,14,16.67,"rutland "
"0","Ryedale","36UF",17,0,17,17,NA,"ryedale"
"1","Ryedale","36UF",1,1,0,17,5.88,"ryedale"
"0","Salford","00BR",48,0,48,48,NA,"salford"
"1","Salford","00BR",2,4,-2,46,4.17,"salford"
"0","Sandwell","00CS",70,0,70,70,NA,"sandwell"
"1","Sandwell","00CS",26,10,16,86,37.14,"sandwell"
"2","Sandwell","00CS",5,10,-5,81,5.81,"sandwell"
"3","Sandwell","00CS",1,3,-2,79,1.23,"sandwell"
"0","Scarborough","36UG",59,0,59,59,NA,"scarborough"
"1","Scarborough","36UG",4,2,2,61,6.78,"scarborough"
"2","Scarborough","36UG",1,4,-3,58,1.64,"scarborough"
"0","Sedgemoor","40UC",39,0,39,39,NA,"sedgemoor"
"1","Sedgemoor","40UC",5,2,3,42,12.82,"sedgemoor"
"2","Sedgemoor","40UC",5,1,4,46,11.9,"sedgemoor"
"3","Sedgemoor","40UC",2,0,2,48,4.35,"sedgemoor"
"0","Sefton","00CA",122,0,122,122,NA,"sefton"
"1","Sefton","00CA",13,6,7,129,10.66,"sefton"
"2","Sefton","00CA",1,2,-1,128,0.78,"sefton"
"3","Sefton","00CA",1,6,-5,123,0.78,"sefton"
"0","Selby","36UH",16,0,16,16,NA,"selby"
"1","Selby","36UH",5,2,3,19,31.25,"selby"
"2","Selby","36UH",3,0,3,22,15.79,"selby"
"3","Selby","36UH",1,1,0,22,4.55,"selby"
"0","Sevenoaks","29UK",25,0,25,25,NA,"sevenoaks"
"2","Sevenoaks","29UK",1,1,0,25,4,"sevenoaks"
"0","Sheffield","00CG",119,0,119,119,NA,"sheffield"
"1","Sheffield","00CG",17,9,8,127,14.29,"sheffield"
"2","Sheffield","00CG",6,5,1,128,4.72,"sheffield"
"3","Sheffield","00CG",3,10,-7,121,2.34,"sheffield"
"0","Shepway","29UL",93,0,93,93,NA,"shepway"
"1","Shepway","29UL",4,7,-3,90,4.3,"shepway"
"0","Shropshire UA","00GG",109,0,109,109,NA,"shropshire "
"1","Shropshire UA","00GG",21,6,15,124,19.27,"shropshire "
"2","Shropshire UA","00GG",7,7,0,124,5.65,"shropshire "
"3","Shropshire UA","00GG",4,1,3,127,3.23,"shropshire "
"0","Slough UA","00MD",18,0,18,18,NA,"slough "
"1","Slough UA","00MD",4,1,3,21,22.22,"slough "
"2","Slough UA","00MD",1,2,-1,20,4.76,"slough "
"0","Solihull","00CT",52,0,52,52,NA,"solihull"
"1","Solihull","00CT",18,4,14,66,34.62,"solihull"
"3","Solihull","00CT",2,3,-1,65,3.03,"solihull"
"0","South Bucks","11UE",18,0,18,18,NA,"south bucks"
"1","South Bucks","11UE",4,0,4,22,22.22,"south bucks"
"2","South Bucks","11UE",1,2,-1,21,4.55,"south bucks"
"0","South Cambridgeshire","12UG",34,0,34,34,NA,"south cambridgeshire"
"1","South Cambridgeshire","12UG",4,4,0,34,11.76,"south cambridgeshire"
"2","South Cambridgeshire","12UG",2,1,1,35,5.88,"south cambridgeshire"
"3","South Cambridgeshire","12UG",1,1,0,35,2.86,"south cambridgeshire"
"0","South Derbyshire","17UK",23,0,23,23,NA,"south derbyshire"
"1","South Derbyshire","17UK",4,0,4,27,17.39,"south derbyshire"
"0","South Gloucestershire UA","00HD",81,0,81,81,NA,"south gloucestershire "
"1","South Gloucestershire UA","00HD",8,11,-3,78,9.88,"south gloucestershire "
"2","South Gloucestershire UA","00HD",1,5,-4,74,1.28,"south gloucestershire "
"3","South Gloucestershire UA","00HD",1,3,-2,72,1.35,"south gloucestershire "
"0","South Hams","18UG",31,0,31,31,NA,"south hams"
"1","South Hams","18UG",5,1,4,35,16.13,"south hams"
"2","South Hams","18UG",1,2,-1,34,2.86,"south hams"
"0","South Holland","32UF",30,0,30,30,NA,"south holland"
"1","South Holland","32UF",5,2,3,33,16.67,"south holland"
"0","South Kesteven","32UG",34,0,34,34,NA,"south kesteven"
"1","South Kesteven","32UG",8,2,6,40,23.53,"south kesteven"
"2","South Kesteven","32UG",2,2,0,40,5,"south kesteven"
"0","South Lakeland","16UG",40,0,40,40,NA,"south lakeland"
"1","South Lakeland","16UG",3,3,0,40,7.5,"south lakeland"
"2","South Lakeland","16UG",3,2,1,41,7.5,"south lakeland"
"3","South Lakeland","16UG",1,2,-1,40,2.44,"south lakeland"
"0","South Norfolk","33UH",40,0,40,40,NA,"south norfolk"
"1","South Norfolk","33UH",8,1,7,47,20,"south norfolk"
"2","South Norfolk","33UH",1,4,-3,44,2.13,"south norfolk"
"3","South Norfolk","33UH",2,0,2,46,4.55,"south norfolk"
"0","South Northamptonshire","34UG",23,0,23,23,NA,"south northamptonshire"
"1","South Northamptonshire","34UG",3,1,2,25,13.04,"south northamptonshire"
"3","South Northamptonshire","34UG",1,3,-2,23,4,"south northamptonshire"
"0","South Oxfordshire","38UD",34,0,34,34,NA,"south oxfordshire"
"1","South Oxfordshire","38UD",4,6,-2,32,11.76,"south oxfordshire"
"2","South Oxfordshire","38UD",1,1,0,32,3.12,"south oxfordshire"
"0","South Ribble","30UN",29,0,29,29,NA,"south ribble"
"1","South Ribble","30UN",5,1,4,33,17.24,"south ribble"
"2","South Ribble","30UN",1,2,-1,32,3.03,"south ribble"
"3","South Ribble","30UN",1,1,0,32,3.12,"south ribble"
"0","South Somerset","40UD",54,0,54,54,NA,"south somerset"
"1","South Somerset","40UD",18,3,15,69,33.33,"south somerset"
"2","South Somerset","40UD",2,7,-5,64,2.9,"south somerset"
"3","South Somerset","40UD",2,5,-3,61,3.12,"south somerset"
"0","South Staffordshire","41UF",26,0,26,26,NA,"south staffordshire"
"1","South Staffordshire","41UF",4,0,4,30,15.38,"south staffordshire"
"2","South Staffordshire","41UF",1,1,0,30,3.33,"south staffordshire"
"0","South Tyneside","00CL",39,0,39,39,NA,"south tyneside"
"1","South Tyneside","00CL",8,5,3,42,20.51,"south tyneside"
"3","South Tyneside","00CL",1,7,-6,36,2.38,"south tyneside"
"0","Southampton UA","00MS",46,0,46,46,NA,"southampton "
"1","Southampton UA","00MS",12,1,11,57,26.09,"southampton "
"2","Southampton UA","00MS",2,2,0,57,3.51,"southampton "
"3","Southampton UA","00MS",2,6,-4,53,3.51,"southampton "
"0","Southend-on-Sea UA","00KF",86,0,86,86,NA,"southend-on-sea "
"1","Southend-on-Sea UA","00KF",11,7,4,90,12.79,"southend-on-sea "
"2","Southend-on-Sea UA","00KF",1,3,-2,88,1.11,"southend-on-sea "
"0","Southwark","00BE",48,0,48,48,NA,"southwark"
"1","Southwark","00BE",3,15,-12,36,6.25,"southwark"
"3","Southwark","00BE",2,6,-4,32,5.56,"southwark"
"0","Spelthorne","43UH",16,0,16,16,NA,"spelthorne"
"1","Spelthorne","43UH",4,0,4,20,25,"spelthorne"
"2","Spelthorne","43UH",1,2,-1,19,5,"spelthorne"
"0","St Albans","26UG",43,0,43,43,NA,"st albans"
"1","St Albans","26UG",5,2,3,46,11.63,"st albans"
"2","St Albans","26UG",2,2,0,46,4.35,"st albans"
"3","St Albans","26UG",1,4,-3,43,2.17,"st albans"
"0","St Edmundsbury","42UF",27,0,27,27,NA,"st edmundsbury"
"1","St Edmundsbury","42UF",2,2,0,27,7.41,"st edmundsbury"
"3","St Edmundsbury","42UF",1,2,-1,26,3.7,"st edmundsbury"
"0","St. Helens","00BZ",35,0,35,35,NA,"st. helens"
"1","St. Helens","00BZ",6,1,5,40,17.14,"st. helens"
"2","St. Helens","00BZ",3,4,-1,39,7.5,"st. helens"
"0","Stafford","41UG",36,0,36,36,NA,"stafford"
"1","Stafford","41UG",6,1,5,41,16.67,"stafford"
"2","Stafford","41UG",2,3,-1,40,4.88,"stafford"
"3","Stafford","41UG",1,4,-3,37,2.5,"stafford"
"0","Staffordshire Moorlands","41UH",30,0,30,30,NA,"staffordshire moorlands"
"1","Staffordshire Moorlands","41UH",2,0,2,32,6.67,"staffordshire moorlands"
"3","Staffordshire Moorlands","41UH",1,2,-1,31,3.12,"staffordshire moorlands"
"0","Stevenage","26UH",14,0,14,14,NA,"stevenage"
"1","Stevenage","26UH",2,3,-1,13,14.29,"stevenage"
"2","Stevenage","26UH",1,1,0,13,7.69,"stevenage"
"3","Stevenage","26UH",1,1,0,13,7.69,"stevenage"
"0","Stockport","00BS",64,0,64,64,NA,"stockport"
"1","Stockport","00BS",5,4,1,65,7.81,"stockport"
"2","Stockport","00BS",2,1,1,66,3.08,"stockport"
"3","Stockport","00BS",1,3,-2,64,1.52,"stockport"
"0","Stockton-on-Tees UA","00EF",40,0,40,40,NA,"stockton-on-tees "
"1","Stockton-on-Tees UA","00EF",14,4,10,50,35,"stockton-on-tees "
"3","Stockton-on-Tees UA","00EF",1,1,0,50,2,"stockton-on-tees "
"0","Stoke-on-Trent UA","00GL",69,0,69,69,NA,"stoke-on-trent "
"1","Stoke-on-Trent UA","00GL",12,2,10,79,17.39,"stoke-on-trent "
"2","Stoke-on-Trent UA","00GL",3,3,0,79,3.8,"stoke-on-trent "
"3","Stoke-on-Trent UA","00GL",3,3,0,79,3.8,"stoke-on-trent "
"0","Stratford-on-Avon","44UE",41,0,41,41,NA,"stratford-on-avon"
"1","Stratford-on-Avon","44UE",5,4,1,42,12.2,"stratford-on-avon"
"2","Stratford-on-Avon","44UE",1,1,0,42,2.38,"stratford-on-avon"
"0","Stroud","23UF",49,0,49,49,NA,"stroud"
"1","Stroud","23UF",7,1,6,55,14.29,"stroud"
"2","Stroud","23UF",1,1,0,55,1.82,"stroud"
"0","Suffolk Coastal","42UG",42,0,42,42,NA,"suffolk coastal"
"1","Suffolk Coastal","42UG",7,7,0,42,16.67,"suffolk coastal"
"2","Suffolk Coastal","42UG",1,1,0,42,2.38,"suffolk coastal"
"0","Sunderland","00CM",91,0,91,91,NA,"sunderland"
"1","Sunderland","00CM",4,5,-1,90,4.4,"sunderland"
"2","Sunderland","00CM",5,3,2,92,5.56,"sunderland"
"0","Surrey Heath","43UJ",19,0,19,19,NA,"surrey heath"
"1","Surrey Heath","43UJ",5,1,4,23,26.32,"surrey heath"
"2","Surrey Heath","43UJ",1,0,1,24,4.35,"surrey heath"
"3","Surrey Heath","43UJ",3,1,2,26,12.5,"surrey heath"
"0","Sutton","00BF",75,0,75,75,NA,"sutton"
"1","Sutton","00BF",9,6,3,78,12,"sutton"
"2","Sutton","00BF",2,2,0,78,2.56,"sutton"
"3","Sutton","00BF",3,3,0,78,3.85,"sutton"
"0","Swale","29UM",46,0,46,46,NA,"swale"
"1","Swale","29UM",4,2,2,48,8.7,"swale"
"2","Swale","29UM",2,5,-3,45,4.17,"swale"
"3","Swale","29UM",3,5,-2,43,6.67,"swale"
"0","Swindon UA","00HX",46,0,46,46,NA,"swindon "
"1","Swindon UA","00HX",7,6,1,47,15.22,"swindon "
"2","Swindon UA","00HX",2,1,1,48,4.26,"swindon "
"3","Swindon UA","00HX",4,2,2,50,8.33,"swindon "
"0","Tameside","00BT",36,0,36,36,NA,"tameside"
"1","Tameside","00BT",4,0,4,40,11.11,"tameside"
"2","Tameside","00BT",1,2,-1,39,2.5,"tameside"
"3","Tameside","00BT",2,3,-1,38,5.13,"tameside"
"0","Tamworth","41UK",11,0,11,11,NA,"tamworth"
"1","Tamworth","41UK",1,0,1,12,9.09,"tamworth"
"2","Tamworth","41UK",1,1,0,12,8.33,"tamworth"
"3","Tamworth","41UK",1,0,1,13,8.33,"tamworth"
"0","Tandridge","43UK",48,0,48,48,NA,"tandridge"
"1","Tandridge","43UK",7,6,1,49,14.58,"tandridge"
"2","Tandridge","43UK",3,3,0,49,6.12,"tandridge"
"3","Tandridge","43UK",1,1,0,49,2.04,"tandridge"
"0","Taunton Deane","40UE",44,0,44,44,NA,"taunton deane"
"1","Taunton Deane","40UE",9,3,6,50,20.45,"taunton deane"
"2","Taunton Deane","40UE",3,2,1,51,6,"taunton deane"
"0","Teignbridge","18UH",75,0,75,75,NA,"teignbridge"
"1","Teignbridge","18UH",9,8,1,76,12,"teignbridge"
"2","Teignbridge","18UH",1,5,-4,72,1.32,"teignbridge"
"0","Telford and Wrekin UA","00GF",46,0,46,46,NA,"telford and wrekin "
"1","Telford and Wrekin UA","00GF",5,2,3,49,10.87,"telford and wrekin "
"3","Telford and Wrekin UA","00GF",1,2,-1,48,2.04,"telford and wrekin "
"0","Tendring","22UN",101,0,101,101,NA,"tendring"
"1","Tendring","22UN",14,2,12,113,13.86,"tendring"
"2","Tendring","22UN",2,5,-3,110,1.77,"tendring"
"3","Tendring","22UN",1,4,-3,107,0.91,"tendring"
"0","Test Valley","24UN",29,0,29,29,NA,"test valley"
"1","Test Valley","24UN",4,1,3,32,13.79,"test valley"
"3","Test Valley","24UN",1,0,1,33,3.12,"test valley"
"0","Tewkesbury","23UG",20,0,20,20,NA,"tewkesbury"
"1","Tewkesbury","23UG",8,1,7,27,40,"tewkesbury"
"0","Thanet","29UN",69,0,69,69,NA,"thanet"
"1","Thanet","29UN",5,4,1,70,7.25,"thanet"
"3","Thanet","29UN",3,5,-2,68,4.29,"thanet"
"0","Three Rivers","26UJ",26,0,26,26,NA,"three rivers"
"1","Three Rivers","26UJ",2,2,0,26,7.69,"three rivers"
"0","Thurrock UA","00KG",22,0,22,22,NA,"thurrock "
"1","Thurrock UA","00KG",15,1,14,36,68.18,"thurrock "
"2","Thurrock UA","00KG",1,1,0,36,2.78,"thurrock "
"0","Tonbridge and Malling","29UP",28,0,28,28,NA,"tonbridge and malling"
"1","Tonbridge and Malling","29UP",2,4,-2,26,7.14,"tonbridge and malling"
"2","Tonbridge and Malling","29UP",1,1,0,26,3.85,"tonbridge and malling"
"0","Torbay UA","00HH",96,0,96,96,NA,"torbay "
"1","Torbay UA","00HH",7,6,1,97,7.29,"torbay "
"3","Torbay UA","00HH",1,5,-4,93,1.03,"torbay "
"0","Torridge","18UK",32,0,32,32,NA,"torridge"
"1","Torridge","18UK",5,5,0,32,15.62,"torridge"
"2","Torridge","18UK",2,3,-1,31,6.25,"torridge"
"3","Torridge","18UK",1,2,-1,30,3.23,"torridge"
"0","Tower Hamlets","00BG",12,0,12,12,NA,"tower hamlets"
"1","Tower Hamlets","00BG",6,3,3,15,50,"tower hamlets"
"0","Trafford","00BU",46,0,46,46,NA,"trafford"
"1","Trafford","00BU",11,5,6,52,23.91,"trafford"
"3","Trafford","00BU",4,1,3,55,7.69,"trafford"
"0","Tunbridge Wells","29UQ",39,0,39,39,NA,"tunbridge wells"
"1","Tunbridge Wells","29UQ",3,4,-1,38,7.69,"tunbridge wells"
"2","Tunbridge Wells","29UQ",1,4,-3,35,2.63,"tunbridge wells"
"0","Uttlesford","22UQ",14,0,14,14,NA,"uttlesford"
"1","Uttlesford","22UQ",2,1,1,15,14.29,"uttlesford"
"2","Uttlesford","22UQ",1,0,1,16,6.67,"uttlesford"
"3","Uttlesford","22UQ",1,1,0,16,6.25,"uttlesford"
"0","Vale of White Horse","38UE",23,0,23,23,NA,"vale of white horse"
"1","Vale of White Horse","38UE",3,1,2,25,13.04,"vale of white horse"
"2","Vale of White Horse","38UE",1,1,0,25,4,"vale of white horse"
"3","Vale of White Horse","38UE",1,0,1,26,4,"vale of white horse"
"0","Wakefield","00DB",72,0,72,72,NA,"wakefield"
"1","Wakefield","00DB",23,5,18,90,31.94,"wakefield"
"2","Wakefield","00DB",3,2,1,91,3.33,"wakefield"
"3","Wakefield","00DB",2,5,-3,88,2.2,"wakefield"
"0","Walsall","00CU",56,0,56,56,NA,"walsall"
"1","Walsall","00CU",20,8,12,68,35.71,"walsall"
"3","Walsall","00CU",2,5,-3,65,2.94,"walsall"
"0","Waltham Forest","00BH",52,0,52,52,NA,"waltham forest"
"1","Waltham Forest","00BH",20,7,13,65,38.46,"waltham forest"
"2","Waltham Forest","00BH",3,5,-2,63,4.62,"waltham forest"
"0","Wandsworth","00BJ",39,0,39,39,NA,"wandsworth"
"1","Wandsworth","00BJ",6,2,4,43,15.38,"wandsworth"
"2","Wandsworth","00BJ",1,7,-6,37,2.33,"wandsworth"
"0","Warrington UA","00EU",39,0,39,39,NA,"warrington "
"1","Warrington UA","00EU",8,2,6,45,20.51,"warrington "
"2","Warrington UA","00EU",3,1,2,47,6.67,"warrington "
"3","Warrington UA","00EU",5,5,0,47,10.64,"warrington "
"0","Warwick","44UF",36,0,36,36,NA,"warwick"
"1","Warwick","44UF",3,2,1,37,8.33,"warwick"
"2","Warwick","44UF",2,1,1,38,5.41,"warwick"
"3","Warwick","44UF",1,2,-1,37,2.63,"warwick"
"0","Watford","26UK",28,0,28,28,NA,"watford"
"1","Watford","26UK",5,3,2,30,17.86,"watford"
"0","Waveney","42UH",40,0,40,40,NA,"waveney"
"1","Waveney","42UH",4,6,-2,38,10,"waveney"
"2","Waveney","42UH",1,1,0,38,2.63,"waveney"
"0","Waverley","43UL",38,0,38,38,NA,"waverley"
"1","Waverley","43UL",10,1,9,47,26.32,"waverley"
"2","Waverley","43UL",1,6,-5,42,2.13,"waverley"
"0","Wealden","21UH",58,0,58,58,NA,"wealden"
"1","Wealden","21UH",13,5,8,66,22.41,"wealden"
"2","Wealden","21UH",5,1,4,70,7.58,"wealden"
"0","Wellingborough","34UH",27,0,27,27,NA,"wellingborough"
"1","Wellingborough","34UH",2,0,2,29,7.41,"wellingborough"
"2","Wellingborough","34UH",1,1,0,29,3.45,"wellingborough"
"3","Wellingborough","34UH",1,1,0,29,3.45,"wellingborough"
"0","Welwyn Hatfield","26UL",20,0,20,20,NA,"welwyn hatfield"
"1","Welwyn Hatfield","26UL",5,1,4,24,25,"welwyn hatfield"
"2","Welwyn Hatfield","26UL",1,0,1,25,4.17,"welwyn hatfield"
"3","Welwyn Hatfield","26UL",1,1,0,25,4,"welwyn hatfield"
"0","West Berkshire UA","00MB",34,0,34,34,NA,"west berkshire "
"1","West Berkshire UA","00MB",4,2,2,36,11.76,"west berkshire "
"2","West Berkshire UA","00MB",1,3,-2,34,2.78,"west berkshire "
"0","West Devon","18UL",32,0,32,32,NA,"west devon"
"1","West Devon","18UL",2,2,0,32,6.25,"west devon"
"0","West Dorset","19UH",50,0,50,50,NA,"west dorset"
"1","West Dorset","19UH",7,1,6,56,14,"west dorset"
"2","West Dorset","19UH",1,2,-1,55,1.79,"west dorset"
"3","West Dorset","19UH",1,4,-3,52,1.82,"west dorset"
"0","West Lancashire","30UP",30,0,30,30,NA,"west lancashire"
"1","West Lancashire","30UP",3,0,3,33,10,"west lancashire"
"2","West Lancashire","30UP",2,3,-1,32,6.06,"west lancashire"
"0","West Lindsey","32UH",39,0,39,39,NA,"west lindsey"
"1","West Lindsey","32UH",5,2,3,42,12.82,"west lindsey"
"2","West Lindsey","32UH",4,2,2,44,9.52,"west lindsey"
"0","West Oxfordshire","38UF",24,0,24,24,NA,"west oxfordshire"
"1","West Oxfordshire","38UF",8,2,6,30,33.33,"west oxfordshire"
"0","West Somerset","40UF",15,0,15,15,NA,"west somerset"
"1","West Somerset","40UF",4,1,3,18,26.67,"west somerset"
"0","Westminster","00BK",21,0,21,21,NA,"westminster"
"1","Westminster","00BK",1,8,-7,14,4.76,"westminster"
"3","Westminster","00BK",1,2,-1,13,7.14,"westminster"
"0","Weymouth and Portland","19UJ",21,0,21,21,NA,"weymouth and portland"
"1","Weymouth and Portland","19UJ",4,2,2,23,19.05,"weymouth and portland"
"2","Weymouth and Portland","19UJ",1,2,-1,22,4.35,"weymouth and portland"
"0","Wigan","00BW",44,0,44,44,NA,"wigan"
"1","Wigan","00BW",9,2,7,51,20.45,"wigan"
"2","Wigan","00BW",4,4,0,51,7.84,"wigan"
"0","Wiltshire UA","00HY",174,0,174,174,NA,"wiltshire "
"1","Wiltshire UA","00HY",25,9,16,190,14.37,"wiltshire "
"2","Wiltshire UA","00HY",5,9,-4,186,2.63,"wiltshire "
"3","Wiltshire UA","00HY",3,6,-3,183,1.61,"wiltshire "
"0","Winchester","24UP",37,0,37,37,NA,"winchester"
"1","Winchester","24UP",4,1,3,40,10.81,"winchester"
"0","Windsor and Maidenhead UA","00ME",42,0,42,42,NA,"windsor and maidenhead "
"1","Windsor and Maidenhead UA","00ME",1,0,1,43,2.38,"windsor and maidenhead "
"3","Windsor and Maidenhead UA","00ME",1,5,-4,39,2.33,"windsor and maidenhead "
"0","Wirral","00CB",124,0,124,124,NA,"wirral"
"1","Wirral","00CB",10,13,-3,121,8.06,"wirral"
"2","Wirral","00CB",4,2,2,123,3.31,"wirral"
"3","Wirral","00CB",2,9,-7,116,1.63,"wirral"
"0","Woking","43UM",30,0,30,30,NA,"woking"
"1","Woking","43UM",4,0,4,34,13.33,"woking"
"0","Wokingham UA","00MF",50,0,50,50,NA,"wokingham "
"1","Wokingham UA","00MF",2,3,-1,49,4,"wokingham "
"3","Wokingham UA","00MF",2,5,-3,46,4.08,"wokingham "
"0","Wolverhampton","00CW",73,0,73,73,NA,"wolverhampton"
"1","Wolverhampton","00CW",8,1,7,80,10.96,"wolverhampton"
"2","Wolverhampton","00CW",1,3,-2,78,1.25,"wolverhampton"
"3","Wolverhampton","00CW",2,10,-8,70,2.56,"wolverhampton"
"0","Worcester","47UE",27,0,27,27,NA,"worcester"
"1","Worcester","47UE",4,2,2,29,14.81,"worcester"
"2","Worcester","47UE",2,2,0,29,6.9,"worcester"
"3","Worcester","47UE",1,8,-7,22,3.45,"worcester"
"0","Worthing","45UH",65,0,65,65,NA,"worthing"
"1","Worthing","45UH",9,4,5,70,13.85,"worthing"
"2","Worthing","45UH",1,3,-2,68,1.43,"worthing"
"3","Worthing","45UH",1,1,0,68,1.47,"worthing"
"0","Wychavon","47UF",33,0,33,33,NA,"wychavon"
"1","Wychavon","47UF",3,0,3,36,9.09,"wychavon"
"2","Wychavon","47UF",1,2,-1,35,2.78,"wychavon"
"0","Wycombe","11UF",24,0,24,24,NA,"wycombe"
"1","Wycombe","11UF",8,5,3,27,33.33,"wycombe"
"2","Wycombe","11UF",3,2,1,28,11.11,"wycombe"
"3","Wycombe","11UF",1,1,0,28,3.57,"wycombe"
"0","Wyre","30UQ",41,0,41,41,NA,"wyre"
"1","Wyre","30UQ",5,4,1,42,12.2,"wyre"
"3","Wyre","30UQ",1,1,0,42,2.38,"wyre"
"0","Wyre Forest","47UG",42,0,42,42,NA,"wyre forest"
"1","Wyre Forest","47UG",7,3,4,46,16.67,"wyre forest"
"2","Wyre Forest","47UG",2,3,-1,45,4.35,"wyre forest"
"0","York UA","00FF",46,0,46,46,NA,"york "
"1","York UA","00FF",2,5,-3,43,4.35,"york "
"2","York UA","00FF",2,3,-1,42,4.65,"york "
"3","York UA","00FF",1,2,-1,41,2.38,"york "
